................**............**o....................................
.S.............*.o*..........*..o....................................
.*.............*.o*..........*..o....................................
.*.............*.o*..........*..o....................................
.*.............*.o*..........*..o....................................
.*.............*.o*..........*..o....................................
.*.............*.o*..........*..o....................................
.*.............*.o*..........*.*o....................................
.****************o*..........**.o....................................
oooooooooooooooooo*..........**.o....................................
..................*..........**.o....................................
..................*..........**.o....................................
..................*..........**.o....................................
..................*..........**.o....................................
..................*..........**.o....................................
..................*..........**.o....................................
..................*..........**.o....................................
..................*..........**.o....................................
..................*..........**.o....................................
..................*..........**.o....................................
..................*..........**.o....................................
..................*..........**.o....................................
..................*..........**.o....................................
..................*..........**.o....................................
...................*.........***o....................................
...................*........*.**o....................................
.....***************************o....................................
...*ooooooooooooooooooooooooooooo....................................
....*................................................................
....*................................................................
....*................................................................
....*................................................................
....*................................................................
....***********************************************************......
oooooooooooooooooooooooooooooooooooooooooooooooooooooooooooooo.*.....
...............................................................*.....
...............................................................*.....
.....****************************************************************
...*ooooooooooooooooooooooooooooooooooooooooooooooooooooooooooooooooo
....*................................................................
....***********************************************************......
oooooooooooooooooooooooooooooooooooooooooooooooooooooooooooooo.*.....
...............................................................*.....
.....****************************************************************
...*ooooooooooooooooooooooooooooooooooooooooooooooooooooooooooooooooo
....*................................................................
....***************************************************************F.
.....................................................................